1331313131313131141331313131311421212121
2200000000000000202200000000003014212121
2200000000000000303200000000000030142121
2200000000000000000000000000000000303114
2200000000000000000000000000000000000020
2200000000000000000000000000000000000020
2200000000000000000000000000000000000020
2312000000000000101200000002030900000020
2122000000000000202200000010111200000020
2122000000000000202200000020212200000020
2123111111111111242311111124212311111124

image image:tiles
sprite @3,9 (u16:spritetype)pumpkin 0x00000000
sprite @1,6 (u16:spritetype)hero 0x00000000
sprite @5,9 (u16:spritetype)pumpkin 0x00000000
