0101010101010101010101010101010101010101
0100000000000000000101000000000101010101
0100000000000000000101000000000001010101
0100000000000000000000000000000000010101
0100000000000000000000000000000000000001
0100000000000000000000000000000000000001
0100000000000000000101000000000000000001
0101000000000000000101000000000000000001
0101010000000000000101000000010100000001
0101010100000000000101000000010100000001
0101010101010101010101010101010101010101

image image:tiles
sprite @7,9 (u16:spritetype)pumpkin 0x00000000
sprite @1,6 (u16:spritetype)hero 0x00000000
sprite @5,9 (u16:spritetype)pumpkin 0x00000000
