0000000000000000000000000000000000000000
0000000000000000000000000000000000000000
0000000000000000000000000000000000000000
0000000000000000000000000000000000000000
0000000000000000000000000017180000000000
0000000015160000000000000027280000000000
0000000025260000000000020303030309000000
1111111111111111111111111111111111111111
2121212121212121212121212121212121212121
2121212121212121212121212121212121212121
2121212121212121212121212121212121212121

image image:tiles
sprite @6,6 (u16:spritetype)pumpkin 0x00000000
sprite @2,6 (u16:spritetype)hero 0x00000000
