0000000000000000000000000000000000000000
0000000000000000000000000000000000000000
0000000000000000000000000000000000000000
0000000000000000000000000000000000000000
000000000000000000191a000000000000000000
000000000000020509292a020709000204090000
0f0f0f0f0f0f0f0f0f0f0f0f0f0f0f0f0f0f0f0f
1f1f1f1f1f1f1f1f1f1f1f1f1f1f1f1f1f1f1f1f
2f2f2f2f2f2f2f2f2f2f2f2f2f2f2f2f2f2f2f2f
3f3f3f3f3f3f3f3f3f3f3f3f3f3f3f3f3f3f3f3f
4f4f4f4f4f4f4f4f4f4f4f4f4f4f4f4f4f4f4f4f

image image:tiles
sprite @1,5 (u16:spritetype)hero 0x00000000
sprite @4,5 (u16:spritetype)pumpkin 0x50000000
