0000000000000000000000000000000000000000
0000000000000000000000000000000000000000
0000000000000000000000000000000000000000
0000000000000000000000000000000000000000
000000000000000000191a000000000000000000
000000000000020509292a020709000204090000
1111111111111111111111111111111111111111
2121212121212121212121212121212121212121
2121212121212121212121212121212121212121
2121212121212121212121212121212121212121
2121212121212121212121212121212121212121

image image:tiles
sprite @1,5 (u16:spritetype)hero 0x00000000
sprite @4,5 (u16:spritetype)pumpkin 0x50000000
