0101010101010101010101010101010101010101
0100000000000000000000000000000000000001
0100000000000000000000000000000000000001
0100000000000000000000000000000000000001
0100000000000000000000000000000000000001
0100000000000000000000000000000000000001
0100000000000000000000000000000000000001
0100000000000000000000000000000000000001
0100000000000000000000000000000000000001
0100000000000000000002030403090000000001
0101010101010101010101010101010101010101

image image:tiles
sprite @2,9 (u16:spritetype)hero 0x00000000
sprite @6,9 (u16:spritetype)pumpkin 0x00000000
