1331313131313131313131313131313131313114
2200000000000000000000000000000000000020
2200000000000000000000000000000000000020
2200000000000000000000000000000000000020
2200000000000000000000000000000000000020
2200000000000000000000000000000000000020
2200000000000000000000000000000000000020
2200000000000000000000000000000000000020
2200000000000000000000000000000000000020
2200000000000000000002030403090002050920
2311111111111111111111111111111111111124

image image:tiles
sprite @2,9 (u16:spritetype)hero 0x00000000
sprite @6,9 (u16:spritetype)pumpkin 0x00000000
