000000000000000000000000494a4a4a4a4a4a4a
000000000000000000000000494a4a4a4a4a4a4a
0000000000000000000000005938383838383836
0000000000000000000000000000000000000034
0000000000000000000000000000000000000034
3a3a3b0000000000000000000000000000000034
4a4a4b00000000000000000000001b1c00000034
4a4a4b00000000000000000000002b2c00000034
5a385b0000000000000000000203030303030934
6a0f0f0f0f0f0f0f0f0f0f0f0f0f0f0f0f0f0f35
1f1f1f1f1f1f1f1f1f1f1f1f1f1f1f1f1f1f1f1f

image image:2
sprite @8,8 (u16:spritetype)pumpkin 0x50000000
sprite @5,8 (u16:spritetype)pumpkin 0x50000000
sprite @1,4 (u16:spritetype)hero 0x00000000
