0000000000000000000000002021212121212121
0000000000000000000000002021212121212121
0000000000000000000000003031313131313114
0000000000000000000000000000000000000020
0000000000000000000000000000000000000020
1111120000000000000000000000000000000020
21212200000000000000000000001b1c00000020
21212200000000000000000000002b2c00000020
2121220000000000000000000203030303030920
2121231111111111111111111111111111111124
2121212121212121212121212121212121212121

image image:2
sprite @8,8 (u16:spritetype)pumpkin 0x50000000
sprite @5,8 (u16:spritetype)pumpkin 0x50000000
sprite @1,4 (u16:spritetype)hero 0x00000000
