0000000000000000000000000000000000000000
0000000000000000000000000000000000000000
0000000000000000000000000000000000000000
0000000000000000000000000000000000000000
0000000000000000000000000000000000020809
0000000000000000000000000000000000898a8b
0000000000000000000000000000020709999a9b
6768000000000000000000000000898a8b999a9b
9a9b000000000000000000020609999a9b999a9b
aaab000000000000000000b9babba9aaaba9aaab
1111111111111111111111111111111111111111

image image:2
sprite @1,6 (u16:spritetype)hero 0x00000000
sprite @8,9 (u16:spritetype)pumpkin 0x54000000
sprite @4,9 (u16:spritetype)pumpkin 0x51000000
sprite @6,9 (u16:spritetype)pumpkin 0x55000000
