0000000000000000000000000000000000000000
0000000000000000000000000000000000000000
0000000000000000000000000000000000000000
0000000000000000000000000000000000000000
0000000000000000000000000000000000020809
0000000000000000000000000000000000101111
0000000000000000000000000000020709202121
0000000000000000000000000000101111242121
0000000000000000000000020609202121212121
0000000000000000000000101111242121212121
1111111111111111111111242121212121212121

image image:2
sprite @1,9 (u16:spritetype)hero 0x00000000
sprite @8,9 (u16:spritetype)pumpkin 0x54000000
sprite @4,9 (u16:spritetype)pumpkin 0x51000000
sprite @6,9 (u16:spritetype)pumpkin 0x55000000
