0000000000000000000000000000000000000000
0000000000000000000000000000000000000000
0000000000000000000000000000000000000000
0000000000000000000000000000000000000000
0203040309000000000000000000000203050309
3d3d3d3d3e000000000000000000003c3d3d3d3d
4d4d4d4d4e000000000000000000004c4d4d4d4d
0d0e5c5d5e000000000000000000007c7d7e0d0e
1d1e6c6d6e000000000000000000008c8d8e1d1e
2d2e4d4d4e000000000000000000004c4d4d2d2e
0a0a0b0a0c0a0a0a0a0a0a0c0b0a0a0c0a0a0b0a

image image:2
sprite @5,9 (u16:spritetype)hero 0x00000000
sprite @14,9 (u16:spritetype)pumpkin 0x51000000
sprite @8,9 (u16:spritetype)pumpkin 0x54000000
sprite @10,9 (u16:spritetype)pumpkin 0x53000000
sprite @12,9 (u16:spritetype)pumpkin 0x52000000
