0000000000000000000000000000000000000000
0000000000000000000000000000000000000000
0000000000000000000000000000000000000000
0000000000000000000000000000000000000000
0203040309000000000000000000000203050309
1111111112000000000000000000001011111111
2121212122000000000000000000002021212121
2121212122000000000000000000002021212121
2121212122000000000000000000002021212121
2121212122000000000000000000002021212121
2121212123111111111111111111112421212121

image image:2
sprite @5,9 (u16:spritetype)hero 0x00000000
sprite @14,9 (u16:spritetype)pumpkin 0x51000000
sprite @8,9 (u16:spritetype)pumpkin 0x54000000
sprite @10,9 (u16:spritetype)pumpkin 0x53000000
sprite @12,9 (u16:spritetype)pumpkin 0x52000000
