0000000000000000000000000000002021212121
0000000000000000000000000000002021212121
0000000000000000000000000000003031313131
0000000000000000000000000000000000000000
0000000000000000000000000000000000000000
1111111111120000000000000000000000000000
1331313131320000000000000000000203070309
2200000000000000000000000000001011111111
2200000000000000000000000000002021212121
2200000000000000000000000000002021212121
2202030603091011111111111111112421212121

image image:2
sprite @2,4 (u16:spritetype)hero 0x00000000
sprite @4,9 (u16:spritetype)pumpkin 0x55000000
sprite @16,5 (u16:spritetype)pumpkin 0x53000000
sprite @5,9 (u16:spritetype)pumpkin 0x56000000
sprite @15,5 (u16:spritetype)pumpkin 0x51000000
