000000000000000000000000000000b69c9d9e9f
000000000000000000000000000000c6c7c7c7c7
000000000000000000000000000000006f006f00
000000000000000000000000000000007f007f00
000000000000000000000000000000007f007f00
3a3a3a3a3a3b000000000000000000008f008f00
37383838385b0000000000000000000203070309
010000000000000000000000000000a6a7a7a7a7
010000000000000000000000000000b6b3b4b5b7
010000000000000000000000000000b6c3c4c5b7
6902030603091011111111111111111111111111

image image:2
sprite @2,4 (u16:spritetype)hero 0x00000000
sprite @4,9 (u16:spritetype)pumpkin 0x55000000
sprite @16,5 (u16:spritetype)pumpkin 0x53000000
sprite @5,9 (u16:spritetype)pumpkin 0x56000000
sprite @15,5 (u16:spritetype)pumpkin 0x51000000
