0000000000000000000000000000000000000000
0000000000000000000000000000000000000000
0000000000000000000000000000000000000000
0000000000000000000000000000000000000000
0000000000000000000000000000000000000000
000000000000000000000000c2000000c100c000
0000000203090000000000001011111111111111
0000000000000000000000002021212121212121
0000000000000000000000002021212121212121
0000000000000000000000002021212121212121
1111111111111111111111112421212121212121

image image:tiles
sprite @4,5 (u16:spritetype)hero 0x00000000
sprite @17,5 (u16:spritetype)princess 0x00000000
sprite @14,5 (u16:spritetype)goblin 0x00000000
